##########
X  #     #
#  #  #  #
#     #  O
##########